1 0 0 0 0 0 0 0 0 0 0 0 0 0 0 1
1 0 4 4 0 3 3 3 3 3 3 3 3 3 3 1
1 0 0 4 0 3 0 0 0 0 0 0 4 0 0 1
1 0 0 0 0 3 0 4 0 4 0 0 0 0 0 1
1 3 3 3 3 3 0 0 4 0 0 0 0 0 0 1
1 0 0 0 0 4 0 0 0 0 0 0 0 0 0 1
1 0 0 0 0 5 5 5 5 5 5 0 0 4 0 1
1 0 0 0 0 5 2 2 2 2 5 0 0 0 0 1
1 4 0 0 0 5 2 2 2 2 5 0 0 0 0 1
1 0 0 4 0 5 2 2 2 2 5 0 0 0 0 1
1 0 0 0 0 5 2 2 2 2 5 0 0 0 0 1
1 1 1 1 1 1 1 1 1 1 1 1 1 1 1 1